%%%%%%
%   .%
% % G%
%P   %
%%%%%%
